[hookmain]
[monitor-x64.dll]

CreateProcessInternalW=nofunc,New_KernelBase_CreateProcessInternalW
//RegCloseKey=nofunc,New_advapi32_RegCloseKey
RegCreateKeyExA=nofunc,New_advapi32_RegCreateKeyExA
RegCreateKeyExW=nofunc,New_advapi32_RegCreateKeyExW
RegDeleteKeyA=nofunc,New_advapi32_RegDeleteKeyA
RegDeleteKeyW=nofunc,New_advapi32_RegDeleteKeyW
RegDeleteValueA=nofunc,New_advapi32_RegDeleteValueA
RegDeleteValueW=nofunc,New_advapi32_RegDeleteValueW
RegEnumKeyExA=nofunc,New_advapi32_RegEnumKeyExA
RegEnumKeyExW=nofunc,New_advapi32_RegEnumKeyExW
RegEnumKeyW=nofunc,New_advapi32_RegEnumKeyW
RegEnumValueA=nofunc,New_advapi32_RegEnumValueA
RegEnumValueW=nofunc,New_advapi32_RegEnumValueW
//RegOpenKeyExA=nofunc,New_advapi32_RegOpenKeyExA
//RegOpenKeyExW=nofunc,New_advapi32_RegOpenKeyExW
RegQueryInfoKeyA=nofunc,New_advapi32_RegQueryInfoKeyA
RegQueryInfoKeyW=nofunc,New_advapi32_RegQueryInfoKeyW
RegQueryValueExA=nofunc,New_advapi32_RegQueryValueExA
RegSetValueExA=nofunc,New_advapi32_RegSetValueExA
RegSetValueExW=nofunc,New_advapi32_RegSetValueExW

DnsQuery_A=nofunc,New_dnsapi_DnsQuery_A
DnsQuery_UTF8=nofunc,New_dnsapi_DnsQuery_UTF8
DnsQuery_W=nofunc,New_dnsapi_DnsQuery_W

GetAdaptersAddresses=nofunc,New_iphlpapi_GetAdaptersAddresses
GetAdaptersInfo=nofunc,New_iphlpapi_GetAdaptersInfo
GetBestInterfaceEx=nofunc,New_iphlpapi_GetBestInterfaceEx
GetInterfaceInfo=nofunc,New_iphlpapi_GetInterfaceInfo

AssignProcessToJobObject=nofunc,New_kernel32_AssignProcessToJobObject
CopyFileA=nofunc,New_kernel32_CopyFileA
CopyFileExW=nofunc,New_kernel32_CopyFileExW
CopyFileW=nofunc,New_kernel32_CopyFileW

//CreateActCtxW=nofunc,New_kernel32_CreateActCtxW
CreateDirectoryExW=nofunc,New_kernel32_CreateDirectoryExW
CreateDirectoryW=nofunc,New_kernel32_CreateDirectoryW
CreateJobObjectW=nofunc,New_kernel32_CreateJobObjectW
CreateProcessInternalW=nofunc,New_kernel32_CreateProcessInternalW
CreateRemoteThread=nofunc,New_kernel32_CreateRemoteThread
CreateRemoteThreadEx=nofunc,New_kernel32_CreateRemoteThreadEx
CreateThread=nofunc,New_kernel32_CreateThread
CreateToolhelp32Snapshot=nofunc,New_kernel32_CreateToolhelp32Snapshot

DeleteFileW=nofunc,New_kernel32_DeleteFileW
DeviceIoControl=nofunc,New_kernel32_DeviceIoControl

FindFirstFileExA=nofunc,New_kernel32_FindFirstFileExA
FindFirstFileExW=nofunc,New_kernel32_FindFirstFileExW
FindResourceA=nofunc,New_kernel32_FindResourceA
//FindResourceExA=nofunc,New_kernel32_FindResourceExA
//FindResourceExW=nofunc,New_kernel32_FindResourceExW
FindResourceW=nofunc,New_kernel32_FindResourceW


GetComputerNameA=nofunc,New_kernel32_GetComputerNameA
GetComputerNameW=nofunc,New_kernel32_GetComputerNameW
GetDiskFreeSpaceExW=nofunc,New_kernel32_GetDiskFreeSpaceExW
GetDiskFreeSpaceW=nofunc,New_kernel32_GetDiskFreeSpaceW
GetFileAttributesExW=nofunc,New_kernel32_GetFileAttributesExW
//GetFileAttributesW=nofunc,New_kernel32_GetFileAttributesW
GetFileInformationByHandle=nofunc,New_kernel32_GetFileInformationByHandle
GetFileInformationByHandleEx=nofunc,New_kernel32_GetFileInformationByHandleEx
GetFileSize=nofunc,New_kernel32_GetFileSize
GetFileSizeEx=nofunc,New_kernel32_GetFileSizeEx
GetFileType=nofunc,New_kernel32_GetFileType
GetNativeSystemInfo=nofunc,New_kernel32_GetNativeSystemInfo

GetShortPathNameW=nofunc,New_kernel32_GetShortPathNameW
GetSystemDirectoryA=nofunc,New_kernel32_GetSystemDirectoryA
GetSystemDirectoryW=nofunc,New_kernel32_GetSystemDirectoryW
GetSystemInfo=nofunc,New_kernel32_GetSystemInfo
GetSystemTime=nofunc,New_kernel32_GetSystemTime
//GetSystemWindowsDirectoryA=nofunc,New_kernel32_GetSystemWindowsDirectoryA
//GetSystemWindowsDirectoryW=nofunc,New_kernel32_GetSystemWindowsDirectoryW
GetTempPathW=nofunc,New_kernel32_GetTempPathW

GetVolumeNameForVolumeMountPointW=nofunc,New_kernel32_GetVolumeNameForVolumeMountPointW

GetVolumePathNameW=nofunc,New_kernel32_GetVolumePathNameW
GetVolumePathNamesForVolumeNameW=nofunc,New_kernel32_GetVolumePathNamesForVolumeNameW

GlobalMemoryStatus=nofunc,New_kernel32_GlobalMemoryStatus
GlobalMemoryStatusEx=nofunc,New_kernel32_GlobalMemoryStatusEx

IsDebuggerPresent=nofunc,New_kernel32_IsDebuggerPresent
//LoadResource=nofunc,New_kernel32_LoadResource
Module32FirstW=nofunc,New_kernel32_Module32FirstW
Module32NextW=nofunc,New_kernel32_Module32NextW
MoveFileWithProgressW=nofunc,New_kernel32_MoveFileWithProgressW
//OutputDebugStringA=nofunc,New_kernel32_OutputDebugStringA
Process32FirstW=nofunc,New_kernel32_Process32FirstW
Process32NextW=nofunc,New_kernel32_Process32NextW
ReadProcessMemory=nofunc,New_kernel32_ReadProcessMemory
//RemoveDirectoryA=nofunc,New_kernel32_RemoveDirectoryA
//RemoveDirectoryW=nofunc,New_kernel32_RemoveDirectoryW

SearchPathW=nofunc,New_kernel32_SearchPathW
//SetEndOfFile=nofunc,New_kernel32_SetEndOfFile
//SetErrorMode=nofunc,New_kernel32_SetErrorMode
SetFileAttributesW=nofunc,New_kernel32_SetFileAttributesW
//SetFileInformationByHandle=nofunc,New_kernel32_SetFileInformationByHandle
SetFilePointer=nofunc,New_kernel32_SetFilePointer
SetFilePointerEx=nofunc,New_kernel32_SetFilePointerEx
SetFileTime=nofunc,New_kernel32_SetFileTime
SetInformationJobObject=nofunc,New_kernel32_SetInformationJobObject
//SetStdHandle=nofunc,New_kernel32_SetStdHandle
SetUnhandledExceptionFilter=nofunc,New_kernel32_SetUnhandledExceptionFilter
//SizeofResource=nofunc,New_kernel32_SizeofResource
Thread32First=nofunc,New_kernel32_Thread32First
Thread32Next=nofunc,New_kernel32_Thread32Next
WriteConsoleA=nofunc,New_kernel32_WriteConsoleA
WriteProcessMemory=nofunc,New_kernel32_WriteProcessMemory
WNetGetProviderNameW=nofunc,New_mpr_WNetGetProviderNameW
system=nofunc,New_msvcrt_system
NetGetJoinInformation=nofunc,New_netapi32_NetGetJoinInformation
NetShareEnum=nofunc,New_netapi32_NetShareEnum
NetUserGetInfo=nofunc,New_netapi32_NetUserGetInfo
NetUserGetLocalGroups=nofunc,New_netapi32_NetUserGetLocalGroups

//LdrGetDllHandle=nofunc,New_ntdll_LdrGetDllHandle
//LdrLoadDll=nofunc,New_ntdll_LdrLoadDll
//LdrUnloadDll=nofunc,New_ntdll_LdrUnloadDll

//NtAllocateVirtualMemory=nofunc,New_ntdll_NtAllocateVirtualMemory
//NtClose=nofunc,New_ntdll_NtClose
NtCreateDirectoryObject=nofunc,New_ntdll_NtCreateDirectoryObject
//NtCreateFile=nofunc,New_ntdll_NtCreateFile
NtCreateKey=nofunc,New_ntdll_NtCreateKey
NtCreateMutant=nofunc,New_ntdll_NtCreateMutant
NtCreateProcess=nofunc,New_ntdll_NtCreateProcess
NtCreateProcessEx=nofunc,New_ntdll_NtCreateProcessEx
//NtCreateSection=nofunc,New_ntdll_NtCreateSection
NtCreateThread=nofunc,New_ntdll_NtCreateThread
NtCreateThreadEx=nofunc,New_ntdll_NtCreateThreadEx
NtCreateUserProcess=nofunc,New_ntdll_NtCreateUserProcess
NtDelayExecution=nofunc,New_ntdll_NtDelayExecution
NtDeleteFile=nofunc,New_ntdll_NtDeleteFile
NtDeleteKey=nofunc,New_ntdll_NtDeleteKey
NtDeleteValueKey=nofunc,New_ntdll_NtDeleteValueKey
NtDeviceIoControlFile=nofunc,New_ntdll_NtDeviceIoControlFile
NtDuplicateObject=nofunc,New_ntdll_NtDuplicateObject
NtEnumerateKey=nofunc,New_ntdll_NtEnumerateKey
NtEnumerateValueKey=nofunc,New_ntdll_NtEnumerateValueKey
NtFreeVirtualMemory=nofunc,New_ntdll_NtFreeVirtualMemory
NtGetContextThread=nofunc,New_ntdll_NtGetContextThread
NtLoadDriver=nofunc,New_ntdll_NtLoadDriver
NtLoadKey=nofunc,New_ntdll_NtLoadKey
NtLoadKey2=nofunc,New_ntdll_NtLoadKey2
NtLoadKeyEx=nofunc,New_ntdll_NtLoadKeyEx
NtMakePermanentObject=nofunc,New_ntdll_NtMakePermanentObject
NtMakeTemporaryObject=nofunc,New_ntdll_NtMakeTemporaryObject
//NtMapViewOfSection=nofunc,New_ntdll_NtMapViewOfSection
NtOpenDirectoryObject=nofunc,New_ntdll_NtOpenDirectoryObject
NtOpenFile=nofunc,New_ntdll_NtOpenFile
//NtOpenKey=nofunc,New_ntdll_NtOpenKey
//NtOpenKeyEx=nofunc,New_ntdll_NtOpenKeyEx
NtOpenMutant=nofunc,New_ntdll_NtOpenMutant
NtOpenProcess=nofunc,New_ntdll_NtOpenProcess
//NtOpenSection=nofunc,New_ntdll_NtOpenSection
NtOpenThread=nofunc,New_ntdll_NtOpenThread
//NtQueryAttributesFile=nofunc,New_ntdll_NtQueryAttributesFile
NtQueryDirectoryFile=nofunc,New_ntdll_NtQueryDirectoryFile
NtQueryFullAttributesFile=nofunc,New_ntdll_NtQueryFullAttributesFile
NtQueryInformationFile=nofunc,New_ntdll_NtQueryInformationFile
//NtQueryKey=nofunc,New_ntdll_NtQueryKey
NtQueryMultipleValueKey=nofunc,New_ntdll_NtQueryMultipleValueKey
//NtQuerySystemInformation=nofunc,New_ntdll_NtQuerySystemInformation
//NtQueryValueKey=nofunc,New_ntdll_NtQueryValueKey
NtQueueApcThread=nofunc,New_ntdll_NtQueueApcThread
NtReadFile=nofunc,New_ntdll_NtReadFile
NtReadVirtualMemory=nofunc,New_ntdll_NtReadVirtualMemory
NtRenameKey=nofunc,New_ntdll_NtRenameKey
NtReplaceKey=nofunc,New_ntdll_NtReplaceKey
NtResumeThread=nofunc,New_ntdll_NtResumeThread
//NtSaveKey=nofunc,New_ntdll_NtSaveKey
NtSaveKeyEx=nofunc,New_ntdll_NtSaveKeyEx
NtSetContextThread=nofunc,New_ntdll_NtSetContextThread
NtSetInformationFile=nofunc,New_ntdll_NtSetInformationFile
NtSetValueKey=nofunc,New_ntdll_NtSetValueKey
NtShutdownSystem=nofunc,New_ntdll_NtShutdownSystem
NtSuspendThread=nofunc,New_ntdll_NtSuspendThread
NtTerminateProcess=nofunc,New_ntdll_NtTerminateProcess
NtTerminateThread=nofunc,New_ntdll_NtTerminateThread
NtUnloadDriver=nofunc,New_ntdll_NtUnloadDriver
NtUnmapViewOfSection=nofunc,New_ntdll_NtUnmapViewOfSection
NtWriteFile=nofunc,New_ntdll_NtWriteFile
NtWriteVirtualMemory=nofunc,New_ntdll_NtWriteVirtualMemory

RtlAddVectoredContinueHandler=nofunc,New_ntdll_RtlAddVectoredContinueHandler
RtlAddVectoredExceptionHandler=nofunc,New_ntdll_RtlAddVectoredExceptionHandler
RtlCompressBuffer=nofunc,New_ntdll_RtlCompressBuffer
RtlCreateUserProcess=nofunc,New_ntdll_RtlCreateUserProcess
RtlCreateUserThread=nofunc,New_ntdll_RtlCreateUserThread
RtlDecompressBuffer=nofunc,New_ntdll_RtlDecompressBuffer
RtlDecompressFragment=nofunc,New_ntdll_RtlDecompressFragment
RtlDispatchException=nofunc,New_ntdll_RtlDispatchException
RtlRemoveVectoredContinueHandler=nofunc,New_ntdll_RtlRemoveVectoredContinueHandler
RtlRemoveVectoredExceptionHandler=nofunc,New_ntdll_RtlRemoveVectoredExceptionHandler

//CoCreateInstance=nofunc,New_ole32_CoCreateInstance
CoCreateInstanceEx=nofunc,New_ole32_CoCreateInstanceEx
CoGetClassObject=nofunc,New_ole32_CoGetClassObject
//CoInitializeEx=nofunc,New_ole32_CoInitializeEx
CoInitializeSecurity=nofunc,New_ole32_CoInitializeSecurity
CoUninitialize=nofunc,New_ole32_CoUninitialize

//OleInitialize=nofunc,New_ole32_OleInitialize
UuidCreate=nofunc,New_rpcrt4_UuidCreate
DecryptMessage=nofunc,New_secur32_DecryptMessage
EncryptMessage=nofunc,New_secur32_EncryptMessage
GetUserNameExA=nofunc,New_secur32_GetUserNameExA
GetUserNameExW=nofunc,New_secur32_GetUserNameExW
ReadCabinetState=nofunc,New_shell32_ReadCabinetState
SHGetFolderPathW=nofunc,New_shell32_SHGetFolderPathW
SHGetSpecialFolderLocation=nofunc,New_shell32_SHGetSpecialFolderLocation
ShellExecuteExW=nofunc,New_shell32_ShellExecuteExW
NetShareEnum=nofunc,New_srvcli_NetShareEnum
ObtainUserAgentString=nofunc,New_urlmon_ObtainUserAgentString
URLDownloadToFileW=nofunc,New_urlmon_URLDownloadToFileW
DrawTextExA=nofunc,New_user32_DrawTextExA
DrawTextExW=nofunc,New_user32_DrawTextExW
ExitWindowsEx=nofunc,New_user32_ExitWindowsEx

//FindWindowA=nofunc,New_user32_FindWindowA
//FindWindowExA=nofunc,New_user32_FindWindowExA
//FindWindowExW=nofunc,New_user32_FindWindowExW
//FindWindowW=nofunc,New_user32_FindWindowW
GetAsyncKeyState=nofunc,New_user32_GetAsyncKeyState
GetCursorPos=nofunc,New_user32_GetCursorPos
//GetForegroundWindow=nofunc,New_user32_GetForegroundWindow
GetKeyState=nofunc,New_user32_GetKeyState
GetKeyboardState=nofunc,New_user32_GetKeyboardState
GetSystemMetrics=nofunc,New_user32_GetSystemMetrics
//LoadStringA=nofunc,New_user32_LoadStringA
//LoadStringW=nofunc,New_user32_LoadStringW
//MessageBoxA=nofunc,New_user32_MessageBoxA
MessageBoxTimeoutA=nofunc,New_user32_MessageBoxTimeoutA
MessageBoxTimeoutW=nofunc,New_user32_MessageBoxTimeoutW
RegisterHotKey=nofunc,New_user32_RegisterHotKey
GetFileVersionInfoExW=nofunc,New_version_GetFileVersionInfoExW
GetFileVersionInfoSizeExW=nofunc,New_version_GetFileVersionInfoSizeExW
GetFileVersionInfoSizeW=nofunc,New_version_GetFileVersionInfoSizeW
GetFileVersionInfoW=nofunc,New_version_GetFileVersionInfoW
DeleteUrlCacheEntryA=nofunc,New_wininet_DeleteUrlCacheEntryA
DeleteUrlCacheEntryW=nofunc,New_wininet_DeleteUrlCacheEntryW
HttpOpenRequestA=nofunc,New_wininet_HttpOpenRequestA
HttpOpenRequestW=nofunc,New_wininet_HttpOpenRequestW
HttpQueryInfoA=nofunc,New_wininet_HttpQueryInfoA
HttpSendRequestA=nofunc,New_wininet_HttpSendRequestA
HttpSendRequestW=nofunc,New_wininet_HttpSendRequestW
InternetCloseHandle=nofunc,New_wininet_InternetCloseHandle
InternetConnectA=nofunc,New_wininet_InternetConnectA
InternetConnectW=nofunc,New_wininet_InternetConnectW
InternetCrackUrlA=nofunc,New_wininet_InternetCrackUrlA
InternetCrackUrlW=nofunc,New_wininet_InternetCrackUrlW
InternetGetConnectedState=nofunc,New_wininet_InternetGetConnectedState
InternetGetConnectedStateExA=nofunc,New_wininet_InternetGetConnectedStateExA
InternetGetConnectedStateExW=nofunc,New_wininet_InternetGetConnectedStateExW
InternetOpenA=nofunc,New_wininet_InternetOpenA
InternetOpenUrlA=nofunc,New_wininet_InternetOpenUrlA
InternetOpenUrlW=nofunc,New_wininet_InternetOpenUrlW
InternetOpenW=nofunc,New_wininet_InternetOpenW
InternetQueryOptionA=nofunc,New_wininet_InternetQueryOptionA
InternetReadFile=nofunc,New_wininet_InternetReadFile
InternetSetOptionA=nofunc,New_wininet_InternetSetOptionA
InternetSetStatusCallback=nofunc,New_wininet_InternetSetStatusCallback
InternetWriteFile=nofunc,New_wininet_InternetWriteFile


timeGetTime=nofunc,New_winmm_timeGetTime
//ConnectEx=nofunc,New_ws2_32_ConnectEx
GetAddrInfoW=nofunc,New_ws2_32_GetAddrInfoW
TransmitFile=nofunc,New_ws2_32_TransmitFile
WSAAccept=nofunc,New_ws2_32_WSAAccept
WSAConnect=nofunc,New_ws2_32_WSAConnect
WSARecv=nofunc,New_ws2_32_WSARecv
WSARecvFrom=nofunc,New_ws2_32_WSARecvFrom
WSASend=nofunc,New_ws2_32_WSASend
WSASendTo=nofunc,New_ws2_32_WSASendTo
WSASocketA=nofunc,New_ws2_32_WSASocketA
WSASocketW=nofunc,New_ws2_32_WSASocketW
//WSAStartup=nofunc,New_ws2_32_WSAStartup
accept=nofunc,New_ws2_32_accept
bind=nofunc,New_ws2_32_bind
closesocket=nofunc,New_ws2_32_closesocket
connect=nofunc,New_ws2_32_connect
getaddrinfo=nofunc,New_ws2_32_getaddrinfo
gethostbyname=nofunc,New_ws2_32_gethostbyname
getsockname=nofunc,New_ws2_32_getsockname
ioctlsocket=nofunc,New_ws2_32_ioctlsocket
listen=nofunc,New_ws2_32_listen
recv=nofunc,New_ws2_32_recv
recvfrom=nofunc,New_ws2_32_recvfrom
select=nofunc,New_ws2_32_select
send=nofunc,New_ws2_32_send
sendto=nofunc,New_ws2_32_sendto
setsockopt=nofunc,New_ws2_32_setsockopt
shutdown=nofunc,New_ws2_32_shutdown
socket=nofunc,New_ws2_32_socket

vbe6_CallByName=nofunc,New_vbe6_vbe6_CallByName
vbe6_Close=nofunc,New_vbe6_vbe6_Close
vbe6_CreateObject=nofunc,New_vbe6_vbe6_CreateObject
vbe6_GetIDFromName=nofunc,New_vbe6_vbe6_GetIDFromName
vbe6_GetObject=nofunc,New_vbe6_vbe6_GetObject
vbe6_Import=nofunc,New_vbe6_vbe6_Import
vbe6_Invoke=nofunc,New_vbe6_vbe6_Invoke
vbe6_Open=nofunc,New_vbe6_vbe6_Open
vbe6_Print=nofunc,New_vbe6_vbe6_Print
vbe6_Shell=nofunc,New_vbe6_vbe6_Shell

CDocument_write=nofunc,New_mshtml_CDocument_write
CElement_put_innerHTML=nofunc,New_mshtml_CElement_put_innerHTML
CHyperlink_SetUrlComponent=nofunc,New_mshtml_CHyperlink_SetUrlComponent
CIFrameElement_CreateElement=nofunc,New_mshtml_CIFrameElement_CreateElement
CImgElement_put_src=nofunc,New_mshtml_CImgElement_put_src
CScriptElement_put_src=nofunc,New_mshtml_CScriptElement_put_src
CWindow_AddTimeoutCode=nofunc,New_mshtml_CWindow_AddTimeoutCode
SetWindowsHookExA=nofunc,New_user32_SetWindowsHookExA
SetWindowsHookExW=nofunc,New_user32_SetWindowsHookExW
UnhookWindowsHookEx=nofunc,New_user32_UnhookWindowsHookEx

OleConvertOLESTREAMToIStorage=nofunc,New_ole32_OleConvertOLESTREAMToIStorage
SendNotifyMessageA=nofunc,New_user32_SendNotifyMessageA
SendNotifyMessageW=nofunc,New_user32_SendNotifyMessageW

PRF=nofunc,New_ncrypt_PRF

WriteConsoleW=nofunc,New_kernel32_WriteConsoleW

MessageBoxW=nofunc,New_user32_MessageBoxW
ControlService=nofunc,New_advapi32_ControlService
CreateServiceA=nofunc,New_advapi32_CreateServiceA
CreateServiceW=nofunc,New_advapi32_CreateServiceW
CryptAcquireContextA=nofunc,New_advapi32_CryptAcquireContextA
CryptAcquireContextW=nofunc,New_advapi32_CryptAcquireContextW
CryptCreateHash=nofunc,New_advapi32_CryptCreateHash
CryptDecrypt=nofunc,New_advapi32_CryptDecrypt
CryptEncrypt=nofunc,New_advapi32_CryptEncrypt
CryptExportKey=nofunc,New_advapi32_CryptExportKey
CryptGenKey=nofunc,New_advapi32_CryptGenKey
CryptHashData=nofunc,New_advapi32_CryptHashData
DeleteService=nofunc,New_advapi32_DeleteService
EnumServicesStatusA=nofunc,New_advapi32_EnumServicesStatusA
EnumServicesStatusW=nofunc,New_advapi32_EnumServicesStatusW
GetUserNameA=nofunc,New_advapi32_GetUserNameA
GetUserNameW=nofunc,New_advapi32_GetUserNameW
LookupAccountSidW=nofunc,New_advapi32_LookupAccountSidW
LookupPrivilegeValueW=nofunc,New_advapi32_LookupPrivilegeValueW
NotifyBootConfigStatus=nofunc,New_advapi32_NotifyBootConfigStatus
OpenSCManagerA=nofunc,New_advapi32_OpenSCManagerA
OpenSCManagerW=nofunc,New_advapi32_OpenSCManagerW
OpenServiceA=nofunc,New_advapi32_OpenServiceA
OpenServiceW=nofunc,New_advapi32_OpenServiceW



//StartServiceA=nofunc,New_advapi32_StartServiceA
StartServiceCtrlDispatcherW=nofunc,New_advapi32_StartServiceCtrlDispatcherW
StartServiceW=nofunc,New_advapi32_StartServiceW
TaskDialog=nofunc,New_comctl32_TaskDialog
CertControlStore=nofunc,New_crypt32_CertControlStore
CertCreateCertificateContext=nofunc,New_crypt32_CertCreateCertificateContext
CertOpenStore=nofunc,New_crypt32_CertOpenStore
CertOpenSystemStoreA=nofunc,New_crypt32_CertOpenSystemStoreA
CertOpenSystemStoreW=nofunc,New_crypt32_CertOpenSystemStoreW
CryptDecodeMessage=nofunc,New_crypt32_CryptDecodeMessage
CryptDecodeObjectEx=nofunc,New_crypt32_CryptDecodeObjectEx
CryptDecryptMessage=nofunc,New_crypt32_CryptDecryptMessage
CryptEncryptMessage=nofunc,New_crypt32_CryptEncryptMessage
CryptHashMessage=nofunc,New_crypt32_CryptHashMessage
CryptProtectData=nofunc,New_crypt32_CryptProtectData
CryptProtectMemory=nofunc,New_crypt32_CryptProtectMemory
CryptUnprotectData=nofunc,New_crypt32_CryptUnprotectData
CryptUnprotectMemory=nofunc,New_crypt32_CryptUnprotectMemory

//LdrGetProcedureAddress=nofunc,New_ntdll_LdrGetProcedureAddress

//Ssl3GenerateKeyMaterial=nofunc,New_ncrypt_Ssl3GenerateKeyMaterial

//GetTimeZoneInformation=nofunc,New_kernel32_GetTimeZoneInformation

//RegQueryValueExW=nofunc,New_advapi32_RegQueryValueExW

//GetLocalTime=nofunc,New_kernel32_GetLocalTime
//GetSystemTimeAsFileTime=nofunc,New_kernel32_GetSystemTimeAsFileTime
//GetTickCount=nofunc,New_kernel32_GetTickCount

//NtProtectVirtualMemory=nofunc,New_ntdll_NtProtectVirtualMemory
//NtQuerySystemTime=nofunc,New_ntdll_NtQuerySystemTime
//EnumWindows=nofunc,New_user32_EnumWindows

IWbemServices_ExecMethod=nofunc,New___wmi___IWbemServices_ExecMethod
IWbemServices_ExecMethodAsync=nofunc,New___wmi___IWbemServices_ExecMethodAsync
//IWbemServices_ExecQuery=nofunc,New___wmi___IWbemServices_ExecQuery
IWbemServices_ExecQueryAsync=nofunc,New___wmi___IWbemSer
